‚òπ	normalized=:(

‚ò∫	normalized=:)
‚òª	normalized=:)
üòä	normalized=:)

üòÇ	normalized=:')

üòÉ	normalized=:D
üòÑ	normalized=:D

üòá	normalized=O:)

üòà	normalized=>:)

üòâ	normalized=;)

üòã	normalized=:P

üòê	normalized=:|

üò†	normalized=:@

üò¢	normalized=:'(
üò≠	normalized=:'(

üò≤	normalized=:o

üò∂	normalized=:X

üåπ	normalized=@>-->--

‚ù§Ô∏è	normalized=<3

üíî	normalized=</3
